                                                                                                                                        
                                                                                                                                        
                                                                                                                                        
                                                                                                                                        
                                                                                                                                        
                                                                                                                                        
                                      +----------------------------------------------------------+                                      
                                      |  \                                                    /  |                                      
                                      |     \                                              /     |                                      
                                      |       >------------------------------------------<       |                                      
                                      |     /                                              \     |                                      
                                      |  /                                                    \  |                                      
                                      +----------------------------------------------------------+                                      
                                                                                                                                        
                                                                                                                                        
                                                                                                                                        
                                                                                                                                        
                                                                                                                                        
                                                                                                                                        
                                      +-------------+                                                                                   
                                      |\           /|                                                                                   
                                      |  \       /  |                                                                                   
                                      |    \   /    |                                                                                   
                                      |      v      |                                                                                   
                                      |      |      |                                                                                   
                                      |      |      |                                                                                   
                                      |      |      |                                                                                   
                                      |      |      |                                                                                   
                                      |      |      |                                                                                   
                                      |      |      |                                                                                   
                                      |      |      |                                                                                   
                                      |      |      |                                                                                   
                                      |      |      |                                                                                   
                                      |      |      |                                                                                   
                                      |      |      |                                                                                   
                                      |      |      |                                                                                   
                                      |      |      |                                                                                   
                                      |      |      |                                                                                   
                                      |      |      |                                                                                   
                                      |      ^      |                                                                                   
                                      |    /   \    |                                                                                   
                                      |  /       \  |                                                                                   
                                      |/           \|                                                                                   
                                      +-------------+                                                                                   
                                                                                                                                        
                                                                                                                                        
                                                                                                                                        
                                                                                                                                        
                                                                                                                                        
                                                                                                                                        
                                      +----------------------------------------------------------+                                      
                                      |  \                                                    /  |                                      
                                      |     \                                              /     |                                      
                                      |       >------------------------------------------<       |                                      
                                      |     /                                              \     |                                      
                                      |  /                                                    \  |                                      
                                      +----------------------------------------------------------+                                      
                                                                                                                                        
                                                                                                                                        
                                                                                                                                        
                                                                                                                                        
                                                                                                                                        
                                                                                                                                        
