+----------------------------------------------------------------------------------------------------------------------------------------------------------------------------------------------------------------------------------------------------------------+
|                                                                                                                                                                                                                                                                |
|                                                                                                                                                                                                                                                                |
|                                                                                                                                                                                                                                                                |
|                                                                                                                                                                                                                                                                |
|                                                                                                                                                                                                                                                                |
|                                                                                                                                                                                                                                                                |
|                                      +----------------------------------------------------------+                                                            +----------------------------------------------------------+                                      |
|                                      |  \                                                    /  |                                                            |  \                                                    /  |                                      |
|                                      |     \                                              /     |                                                            |     \                                              /     |                                      |
|                                      |       >------------------------------------------<       |                                                            |       >------------------------------------------<       |                                      |
|                                      |     /                                              \     |                                                            |     /                                              \     |                                      |
|                                      |  /                                                    \  |                                                            |  /                                                    \  |                                      |
|                                      +----------/-----------/------------/-----------/----------+                                                            +----------/-----------/------------/-----------/----------+                                      |
|                                                                                                                                                                                                                                                                |
|                                                                                                                                                                                                                                                                |
|                                                                                                                                                                                                                                                                |
|                                                                                                                                                                                                                                                                |
|                                                                                                                                                                                                                                                                |
|                                                                                                                                                                                                                                                                |
|                                      +-------------+                                             +----------\-----------\------------\-----------\----------+                                             +-------------+                                      |
|                                      |\           /|                                             |  \                                                    /  |                                             |\           /|                                      |
|                                      |  \       /  |                                             |     \                                              /     |                                             |  \       /  |                                      |
|                                      |    \   /    |                                             |       >------------------------------------------<       |                                             |    \   /    |                                      |
|                                      |      v      /                                             |     /                                              \     |                                             \      v      |                                      |
|                                      |      |      |                                             |  /                                                    \  |                                             |      |      |                                      |
|                                      |      |      |                                             +----------------------------------------------------------+                                             |      |      |                                      |
|                                      |      |      |                                                                                                                                                      |      |      |                                      |
|                                      |      |      |                                                                                                                                                      |      |      |                                      |
|                                      |      |      /                                                                                                                                                      \      |      |                                      |
|                                      |      |      |                                                                                                                                                      |      |      |                                      |
|                                      |      |      |                                                                                                                                                      |      |      |                                      |
|                                      |      |      |                                                                                                                                                      |      |      |                                      |
|                                      |      |      |                                                                                                                                                      |      |      |                                      |
|                                      |      |      |                                                                                                                                                      |      |      |                                      |
|                                      |      |      /                                                                                                                                                      \      |      |                                      |
|                                      |      |      |                                                                                                                                                      |      |      |                                      |
|                                      |      |      |                                                                                                                                                      |      |      |                                      |
|                                      |      |      |                                             +----------\-----------\------------\-----------\----------+                                             |      |      |                                      |
|                                      |      |      |                                             |  \                                                    /  |                                             |      |      |                                      |
|                                      |      ^      /                                             |     \                                              /     |                                             \      ^      |                                      |
|                                      |    /   \    |                                             |       >------------------------------------------<       |                                             |    /   \    |                                      |
|                                      |  /       \  |                                             |     /                                              \     |                                             |  /       \  |                                      |
|                                      |/           \|                                             |  /                                                    \  |                                             |/           \|                                      |
|                                      +-------------+                                             +----------------------------------------------------------+                                             +-------------+                                      |
|                                                                                                                                                                                                                                                                |
|                                                                                                                                                                                                                                                                |
|                                                                                                                                                                                                                                                                |
|                                                                                                                                                                                                                                                                |
|                                                                                                                                                                                                                                                                |
|                                                                                                                                                                                                                                                                |
|                                      +----------\-----------\------------\-----------\----------+                                                            +----------\-----------\------------\-----------\----------+                                      |
|                                      |  \                                                    /  |                                                            |  \                                                    /  |                                      |
|                                      |     \                                              /     |                                                            |     \                                              /     |                                      |
|                                      |       >------------------------------------------<       |                                                            |       >------------------------------------------<       |                                      |
|                                      |     /                                              \     |                                                            |     /                                              \     |                                      |
|                                      |  /                                                    \  |                                                            |  /                                                    \  |                                      |
|                                      +----------------------------------------------------------+                                                            +----------------------------------------------------------+                                      |
|                                                                                                                                                                                                                                                                |
|                                                                                                                                                                                                                                                                |
|                                                                                                                                                                                                                                                                |
|                                                                                                                                                                                                                                                                |
|                                                                                                                                                                                                                                                                |
|                                                                                                                                                                                                                                                                |
+----------------------------------------------------------------------------------------------------------------------------------------------------------------------------------------------------------------------------------------------------------------+
