                                                                                                                                                                                                                                                                
                                                                                                                                                                                                                                                                
                                                                                                                                                                                                                                                                
                                                                                                                                                                                                                                                                
                                                                                                                                                                                                                                                                
                                                                                                                                                                                                                                                                
                                      +----------------------------------------------------------+                                                            +----------------------------------------------------------+                                      
                                      |  \                                                    /  |                                                            |  \                                                    /  |                                      
                                      |     \                                              /     |                                                            |     \                                              /     |                                      
                                      |       >------------------------------------------<       |                                                            |       >------------------------------------------<       |                                      
                                      |     /                                              \     |                                                            |     /                                              \     |                                      
                                      |  /                                                    \  |                                                            |  /                                                    \  |                                      
                                      +----------/-----------/------------/-----------/----------+                                                            +----------/-----------/------------/-----------/----------+                                      
                                                                                                                                                                                                                                                                
                                                                                                                                                                                                                                                                
                                                                                                                                                                                                                                                                
                                                                                                                                                                                                                                                                
                                                                                                                                                                                                                                                                
                                                                                                                                                                                                                                                                
                                      +-------------+                                             +----------\-----------\------------\-----------\----------+                                             +-------------+                                      
                                      |\           /|                                             |  \                                                    /  |                                             |\           /|                                      
                                      |  \       /  |                                             |     \                                              /     |                                             |  \       /  |                                      
                                      |    \   /    |                                             |       >------------------------------------------<       |                                             |    \   /    |                                      
                                      |      v      /                                             |     /                                              \     |                                             \      v      |                                      
                                      |      |      |                                             |  /                                                    \  |                                             |      |      |                                      
                                      |      |      |                                             +----------------------------------------------------------+                                             |      |      |                                      
                                      |      |      |                                                                                                                                                      |      |      |                                      
                                      |      |      |                                                                                                                                                      |      |      |                                      
                                      |      |      /                                                                                                                                                      \      |      |                                      
                                      |      |      |                                                                                                                                                      |      |      |                                      
                                      |      |      |                                                                                                                                                      |      |      |                                      
                                      |      |      |                                                                                                                                                      |      |      |                                      
                                      |      |      |                                                                                                                                                      |      |      |                                      
                                      |      |      |                                                                                                                                                      |      |      |                                      
                                      |      |      /                                                                                                                                                      \      |      |                                      
                                      |      |      |                                                                                                                                                      |      |      |                                      
                                      |      |      |                                                                                                                                                      |      |      |                                      
                                      |      |      |                                             +----------\-----------\------------\-----------\----------+                                             |      |      |                                      
                                      |      |      |                                             |  \                                                    /  |                                             |      |      |                                      
                                      |      ^      /                                             |     \                                              /     |                                             \      ^      |                                      
                                      |    /   \    |                                             |       >------------------------------------------<       |                                             |    /   \    |                                      
                                      |  /       \  |                                             |     /                                              \     |                                             |  /       \  |                                      
                                      |/           \|                                             |  /                                                    \  |                                             |/           \|                                      
                                      +-------------+                                             +----------------------------------------------------------+                                             +-------------+                                      
                                                                                                                                                                                                                                                                
                                                                                                                                                                                                                                                                
                                                                                                                                                                                                                                                                
                                                                                                                                                                                                                                                                
                                                                                                                                                                                                                                                                
                                                                                                                                                                                                                                                                
                                      +----------\-----------\------------\-----------\----------+                                                            +----------\-----------\------------\-----------\----------+                                      
                                      |  \                                                    /  |                                                            |  \                                                    /  |                                      
                                      |     \                                              /     |                                                            |     \                                              /     |                                      
                                      |       >------------------------------------------<       |                                                            |       >------------------------------------------<       |                                      
                                      |     /                                              \     |                                                            |     /                                              \     |                                      
                                      |  /                                                    \  |                                                            |  /                                                    \  |                                      
                                      +----------------------------------------------------------+                                                            +----------------------------------------------------------+                                      
                                                                                                                                                                                                                                                                
                                                                                                                                                                                                                                                                
                                                                                                                                                                                                                                                                
                                                                                                                                                                                                                                                                
                                                                                                                                                                                                                                                                
                                                                                                                                                                                                                                                                
